11111
10001
1E001
1C001
100P1
11111
