1111111
10E0001
1C000P1
1111111