111111111111
1EC000000001
100000000001
1000P0000001
111111111111