111111
1EC001
100001
1000P1
111111