11111111111111111
10000E01000001001
10111111000001001
1C000000000000001
1000000000000C001
10000000000000001
10000000000000001
10000000000000001
1P000000000000001
11111111111111111