11111111111111111
10000E01000001C01
10111111000001001
1C000000000000001
10000000000000001
10000000000000001
10000000000000001
10000000CCC000001
100000000000000P1
11111111111111111