11111111111111111
10000E10000001C11
10111110P00001001
1C000000000000011
11111111111111111