11111111111111111
10000ECCCCCCC0101
10111111000001001
1C000000000000001
100000C000000C001
100000C0000000001
10000C00000000001
10000000000000001
1P000000000000001
11111111111111111