11111
1E001
1C001
10P01
11111
