11111111111111111
1E000000000001111
11110000000000111
1000000000000C011
1000001C000000001
10000000000000001
10000000000000011
1P0C00011100C1111
11111111111111111