11111111111111111
111E0000000000111
11111111000001111
1C000000000001111
110000000000C1111
100000C0000011111
10000111000000001
10000000000000001
1P1111000000C0001
11111111111111111