11111111111111111
1E000000000001111
11110000000011111
1111100000000C011
1000000C000001111
10000001000000001
10000000000000P11
100C11111100C1111
11111111111111111