11111111111111111
1000000C000001111
11110000000000111
1000000E00000C011
1000001C000000001
1000000000W000001
10000000000000011
1P0C00011100C1111
11111111111111111