11111111111111111
1E0000W0000000111
11111000000001111
1C001000000001111
110010000000C1111
100000C0000011111
10000111000000001
10000000000000001
1P0111000000C0001
11111111111111111