111111111
1E00000C1
100000011
100000001
100000001
1000000P1
111111111